
   E     E

#####   #########
#           #   #
#           #   # 
#           #   #
#     O         #
#               #
#           #   #
#################