      ########################
      #                      #
      #          E           #
      #                      #
      #      #               #
      #      #               #
      #      #               #
      #      #            E  #
      #      #               #
      #   ########   #########
             #           #   #
             #           #   # 
             #           #   #
             #     O         #
             #               #
             #           #   #
             #################