#####   #####
#           #
#           #
#     O     #
#           #
#           #
#############